111111111111111
1P0000C111111E1
11000001000C001
111100000000001
10C000000000001
111111111111111