111111111111111111111111111111
1C0000000000011E11110000C00001
111111111111011011110000001111
1P00000000000000000000011111C1
110011000000000111000000000001
11001C01111111111C000000000001
111111111111111111111111111111